{
  "maps": [
    {
      "id": "easy",
      "description": "",
      "terrains": [
        "WWWW",
        "WFF>",
        "WFWW",
        "WFFW",
        "WWFW",
        "<FFW",
        "WWWW"
      ]
    },
    {
      "id": "medium",
      "description": "",
      "terrains": [
        "WWWWWWWWWWWWWWWWWWWWWWWWWWWWWWWWWWWWWWWWW",
        "WFFFWFFFFFWFFFFFWFFFFFFFFFFFFFFFFFFFWFFFW",
        "WFWFWFWWWFWFWWWFWFWWWWWWWWWWWWWWWFWFWFWFW",
        "WFWFFFWFFFFFWFWFWFFFFFFFWFWFFFWFFFWFWFWF>",
        "WFWWWWWWWWWWWFWFWWWWWWWFWFWFWFWFWWWFWFWWW",
        "WFWFFFFFWFFFFFWFFFFFWFFFFFWFWFFFWFFFWFFFW",
        "WFWFWWWFWFWWWFWWWWWFWWWWWWWFWWWWWFWWWFWFW",
        "WFWFWFFFWFFFWFWFFFFFWFFFFFFFWFFFFFWFFFWFW",
        "WFWFWFWWWFWWWFWFWWWWWFWWWWWWWFWWWWWWWWWFW",
        "WFFFWFWFFFWFFFWFFFWFFFWFFFFFFFFFFFFFFFWFW",
        "WFWWWFWFWWWFWWWWWFWFWWWWWWWWWWWWWWWWWFWFW",
        "WFWFFFWFWFWFFFFFWFFFWFFFFFFFFFFFFFFFWFFFW",
        "WFWFWWWFWFWWWFWWWWWFWFWWWWWWWWWWWWWFWWWFW",
        "WFWFWFFFFFFFWFFFFFFFWFWFWFFFFFFFFFWFFFWFW",
        "WFWFWFWWWWWFWWWWWWWWWFWFWFWWWFWFWWWWWFWWW",
        "WFWFWFWFFFWFWFFFFFWFWFWFFFWFFFWFWFFFWFFFW",
        "WFWFWWWFWFWFWWWFWFWFWFWWWWWFWWWWWFWFWFWFW",
        "WFWFFFFFWFWFFFWFWFFFWFWFFFFFWFFFWFWFWFWFW",
        "WFWWWWWWWFWWWFWFWWWWWFWFWWWFWFWFWFWFWWWFW",
        "WFWFWFFFFFWFFFWFWFFFFFWFFFWFWFWFFFWFFFWFW",
        "WFWFWFWWWWWWWFWFWFWWWWWWWFWWWFWWWWWWWFWFW",
        "WFWFWFFFFFFFWFWFWFWFFFFFWFFFWFFFWFFFWFWFW",
        "WFWFWWWWWWWFWFWFWFWFWWWFWWWFWWWFWWWFWFWFW",
        "WFWFFFFFFFWFWFFFWFWFFFWFWFFFWFFFWFFFWFWFW",
        "WFWFWWWWWWWFWWWWWFWWWFWFWFWFWFWWWFWWWFWFW",
        "WFWFFFWFFFFFWFFFFFFFFFWFFFWFWFWFFFFFFFFFW",
        "WFWWWFWFWWWWWFWWWWWFWWWWWWWFWFWWWWWWWWWWW",
        "WFFFFFWFFFFFFFWFFFWFWFFFWFFFWFFFFFFFFFFFW",
        "WWWWWFWWWWWWWWWFWFWWWFWFWFWWWWWWWWWWWWWFW",
        "WFFFFFFFFFWFFFFFWFFFFFWFWFFFFFFFWFFFWFFFW",
        "WFWWWWWFWWWFWWWWWWWWWWWFWWWWWWWFWFWWWFWFW",
        "WFWFFFWFWFFFWFFFWFFFWFFFWFFFWFFFFFWFFFWFW",
        "WFWFWFWFWFWWWFWFWFWFWFWWWFWFWWWWWWWFWWWFW",
        "WFWFWFWFWFWFFFWFFFWFWFWFFFWFFFWFFFFFWFFFW",
        "WWWFWFWWWFWFWWWFWWWWWFWFWWWWWFWFWWWWWFWWW",
        "WFFFWFWFFFWFFFWFWFFFWFFFWFFFWFWFFFFFWFWFW",
        "WFWWWFWFWWWWWFWFWFWFWWWWWFWFWFWWWWWFWFWFW",
        "WFWFFFWFWFFFFFWFWFWFFFFFFFWFWFWFFFFFWFWFW",
        "WFWFWWWFWFWWWWWWWFWWWWWFWWWWWFWFWWWWWFWFW",
        "<FWFFFFFWFFFFFFFFFFFFFWFFFFFFFFFWFFFFFFFW",
        "WWWWWWWWWWWWWWWWWWWWWWWWWWWWWWWWWWWWWWWWW"
      ]
    }
  ]
}